NO      ./texture/    bo njo ur
S ./texture/    bo njo ur


EA ./   text_test_2
SO ./texture/salutation.  
WE ./text_test_4


F 46, 33 , 2    
C     234,      255 ,   0    
R   12     234  

     1111111111
111111000000001111
    11000001111111
11111111100000000111   
10000000000000000001
10000111111111111111
111111