NO      ./texture/
S ./texture/    bo njo ur

EA ./texture/   text_test_2
SO ./texture/salutation.  
WE ./texture/text_test_4

F 0, 255, 0    
C     255,      0 ,   255    
R   760     540

                  11
                 1001
                 1011111
                 1N100001111
               11100000000001
             110010100000001
           11000000000001001
          101000000000001001
          100000000000020001
          100000000001010001                              11
          120001100000000001                            11001
           1111 10000110001                            1000011
                 1000011101                           110000001
                  1001   1                           100000011
                 100101                              11100001
                  10001                             10000111
                 11001                             100011
                100001                             10001
                101001                              10001    1111
                 11001                              1001    100001
                 100001     1                        101    100001
                 10001  111101                      1001    1000001
               1111000110001011                     101    10000101
              100020001001010001             1111   1001   100000011
               1100000000000001             10000111101   10011000001 11   111
               100001000000001               1000000001111000110011001001 10001
              110000110000011            1111100000000100000011001 100000110001
             100000000000001 1    11    10000000000000000000000001  10000000001
             100000000000001101111001 110000000000001010000000111    111110000111
       1     10000000000000000000000010000100110000010000000001001       100000001
     1101    10010000000200000000001200110111 1001110000002000000111    10000000001
 111100011    1010010000000000100000000011    10011100000000000000001    1100000001
10000000001  1 1101 100000000010000000001     10010000002000000000001      10000001 
1000000000111011001  10000000000000000001     1001000010000000000001       10000001
 1000000000000000011  1000000000000000001    1111 1011 10000000000001      10000001 
  11110001100010000011000000010000000001   1100101001   110000000001   111100000001
      10011000000000000000101 10000000001 1000000001      1000000001  1000000000001
       1000000100000000100001110000000001100001000111     100000101  1000110000001  
        11010110100000000011000000000000000010111100011   12000000011000001000011
        100000000000000000002000000000000000000011110001   11100000000000011011
         1111000000000000000000000000000000000001000001      1000002000001  1 
           10010000000000000001100000000000000000000001      101000000011
           1001000000000000011 10000000010000001000101   1111100000000001
          1100000000000000001  10000102000000001110001  10000000000001001
         10000000000000000001  10010100000000000110021  1001000000002001
         1000000000000010011    10000000000000001100001  100000000000001
          1100000000000111       1100000000000000111001  10100000000001
            10010011000101         100000000000101 10001110100000000001
           10000011100000011       10000000000010110000000000100000001
          1001111100000000001      10000000000000000000000000000001101
          1000011110000000001     100000000000000000000001100000001 1
           100000000000000001      1110000001100000000000000000011
            11011101000110001        110002100000001011000001111
             100000000111111        100010010000000000000000111
            100100000000001          100000000000000010000000001
             10000000000001          100010000000001010000000001
              110000100101            11110000000101011000100001
                1000000001                111000110001 111000001
               1000000011                    11110001     1000001
               100000000011                     10001      110001
             111101000000001                     101         101
            1000000000000001                      1          101
           100000000000000001                                 1
            11100000000000001
               11000000000001
                100000000001
                 1110010011
                    11 11