NO      ./maps/texture/wall_r.png
S ./maps/texture/rock.png

EA ./maps/texture/wall_g.png
SO      ./maps/texture/wall_s.png
WE ./maps/texture/wall_y.png

F 0, 255, 0    
C     255,      0 ,   255    
R   1080 1024

11111111111111111111111111111
10000000001100000000010000001
11111000011100000000000010001
1    1001010000000000000000011111
11111000011100000000000010001
   1000000000110000011101111011
11110111111111011100000010001
11110111111111011101010010001
11000000110101011100000010001
10002000000000001100000010001
10000200000000001100010000001
11000001010101000000000000001
11110111110101000000000000001
10000000001100000101111111111
10000000000000000001000100001
10000000001000010001100W00011
10000000001101000001100000001
10000000000100000001001010001
11111111111111111111111111111