NO      ./texture/
S ./texture/    bo njo ur

EA ./   text_test_2
SO ./texture/salutation.  
WE ./text_test_4

F 46, 33 , 2    
C     234,      255 ,   0    
R   12     234  

111111111111111
    11000001111111
111111111000000111111
1000000N0000000000001
100001111111111111111
111111
111 111
101 101
111 111
1111111111111111111
1000000000000000001
1000011111111111111
111111
1111111111111111111111111111111111
1000000000000000000000000000000001
1000011111111111111111111110000001
111111                   111111111